[
  {
    "author": "RepComm",
    "level": 1,
    "data": [
      "                 ",
      " ----------g---- ",
      "                 ",
      "   #   &         ",
      "       |         ",
      "       |         ",
      "       |         ",
      "       |    *    ",
      "       |         ",
      " &--g--+----b--- ",
      "                 ",
      "                 ",
      "       $         ",
      "                 "
    ]
  }
]